#^.^~****^*~~.~^~..~~~^~.^~.*~**.^^*^*^~..*^^..~^.
#.*~*.~^^^~~.*~*.**.~~^*^**.^~*^^.*^...^..^.**.~^*
#^***~.*^*^..^**.~~~.~*.~^^~^~^.^~^*~**.~*^.^**.*.
#~~.~^.~*~^~^^*^**.~.*^^*~~^^*~.^.*^^*^.^.~~^^^*~.
#.^~^^.~^.^.^^*~^~~*^..^~^~~^.*^^..**.**~.~~^~*~**
#.^^~^.*~**.*~*^*~^*~~^.^.~.~^**~.^^^^*.~.~~~^^.^.
#~~.*.^~~~^*.^*~~~*^.^**^*^.^.^~~***^^*^.~^^.^^.~.
#~.*~~^*.**.~^^~**^.^.^~~~^.~.^~~^^.~^^.^^~.~.~.*^
#^^^~~*~.^.~.*~.~~..~*~^.~**~..^****~.*~^~~*~**^~^
#^^*^^**...*.^^*^^^.*~*~^^~*~~.~****~~~~***.^^~~^~
##*^^^^^.^~.^~.^.^^~*~^*~**^*^.~~~*^.^^~**~*~.....
*###~~~^~*~****.**^~.^.*^^^~.^...~.**^^^^~^.~^~.~*
^*~###~*^.~.^^^^^*~.**~^.*^*.~~..^~~~*~*^.~~^*^*^^
~*^.^#.**~**^*^~***^~~*^*.*~..~^^***^.*~.^*^^^^.~.
*~^~^#*^^*^^~^*~^^*~~~*^*~~~~*~^^^*~..~~~~~.*~^~*.
^.*.^#^**^^^~**.*.~^~~~^..~~~*~~^*~..^^.^~*.^~^~**
.***^##*^~~~~^~.*^~~.*.~^.^^*.***^~^.*....~.^.*~^^
^^~~~~##########^~~^....*~*^~*^^.^~~~^*.~^^^~**^~~
^~~*^*.~.*^^^*^####~*...~**^.^^~.^^.^..^.^**.^^..*
~^***~^.~.~^^^*~~~##..^~^^.~^.~.**...~^~**~^~~**^~
~~~^~.^*.^*.~*.*~~^#.~*^^~~**.*.*.~^^^..^.~^.*.^~~
^^~...^.*~.^^**~^~*###~^~*....^.^^**~.*.^^*..~*~.*
^..^...~.~.*.~***~*~~#..~*~^^~~^~**^~~^*^^~*.~*^*^
*^.**^~*****.~~~..~^~##.^*~^.^^*^..*~^.^.^*.^.~^^*
~...~*^....*^.*^^*...^#~~..^.*~.*~.*^.^*^*^.****^~
^..~***^.*^~~.****.~*^#~.^~*.~^*^~^.****~..~*..*^~
.~^~**~^^..~~~^..*~*.^#*~..^^*.~.*..*~~*~.^~.~*~~.
.***~..~**^.~.~.~*.~~*##.^.^~..~*~~~~*.**~~^..^.^^
~.*.~^*^*~^.~*..*~^~~.*####*.*..^~.*~^^*.~^.^~^**^
.*^~^^*.^*.~*...*~~~*.**.~####.*^.^*.^*~*.^~^**^*.
.~..*....~..~.***~..~^..~~^*^#^~^^~~**^.*~**^**^^*
^.*.~.^.**^*^.~^^*.~..*^~*^**##~**..^.~~*..^*^~*.~
^~~^~~*.~^^~~^**.^.^^^*^.*^^~~#^.*~^*^^..**..**..^
^.^*.*^..*.~~.^^***^.*~..~.**^#.~^...^^~*.~^~^..~~
~^^.^..*^^.**.~~^*~*^~*~^~~.~*#^~.~*^~*.*..^.^^*^*
^^.~*^~~*.~~*~.^..~*.^.~**.^*^#^~.**.~*.~...~~..*.
.~..^.~.~.^*.~^*~.~.*^*~~*.^.*#****~*~~*^~~~^.~~*~
~.*..^^*^~*.~~.~.^~..~.~^^^.*~###*~^*~*^*^^~..^~^^
*.^*^**^*.^^*....**..~^^~.^*^.*~###*^^###.^^*^^^.~
^*^~^^*.~*~^*~^~~.*.^*^~*^^~.*~.*~#####~#~~.~*^~~*
~~**~*.^.*~..~~^^^~^^^.~***^*.^*~^*~^~*~##...~..~.
*~**^~~.^.*.~^**~*^^.*^*.^~~*~~~*^.*..~~^#^.*^.^.*
.*^~..*~.*^^^^^~~^^*.~*.~~~.***~^.*..~~**#***~~^*.
.^^..^.^*^~^.~*...**~~~.**^*~~~*^***~^*^~#~~^^^*.*
**.**~.**~.*.*^~~.~^.*^.~~*.^*.~.***~*^^.#~*.~*^*^
~..^.****^.****~^~***..^^^^*^.~*^^*.~~.^*#^*~^*.~~
^*~^.~*...^^.^~.^^..~^...**...^****^*~*~*###~^*~.~
...^~^.~^^~~~~.*^~.^~***~~^^^.*^^.~.^*~*~**#***^~^
.~~~~~^^.~~*^.~^^^**~^~.^~^~*..^*~^^*..*~^~#######
~^**.~**..*^~^^^.^*^~^~*^.~*~.^.**.^.^^.~**^~~^~^#
