#^.^~****^*~~.~^~..~~~^~.^~.*~**.^^*^*^~..*^^..~^.
*#*~*.~^^^~~.*~*.**.~~^*^**.^~*^^.*^...^..^.**.~^*
^^#**~.*^*^..^**.~~~.~*.~^^~^~^.^~^*~**.~*^.^**.*.
*~~#~^.~*~^~^^*^**.~.*^^*~~^^*~.^.*^^*^.^.~~^^^*~.
*.^~#^.~^.^.^^*~^~~*^..^~^~~^.*^^..**.**~.~~^~*~**
^.^^~#.*~**.*~*^*~^*~~^.^.~.~^**~.^^^^*.~.~~~^^.^.
*~~.*.#~~~^*.^*~~~*^.^**^*^.^.^~~***^^*^.~^^.^^.~.
.~.*~~^#.**.~^^~**^.^.^~~~^.~.^~~^^.~^^.^^~.~.~.*^
.^^^~~*~#^.~.*~.~~..~*~^.~**~..^****~.*~^~~*~**^~^
^^^*^^**.##*.^^*^^^.*~*~^^~*~~.~****~~~~***.^^~~^~
..*^^^^^.^~#^~.^.^^~*~^*~**^*^.~~~*^.^^~**~*~.....
**.^~~~^~*~*#**.**^~.^.*^^^~.^...~.**^^^^~^.~^~.~*
^*~.*.~*^.~.^#^^^*~.**~^.*^*.~~..^~~~*~*^.~~^*^*^^
~*^.^..**~**^#^~***^~~*^*.*~..~^^***^.*~.^*^^^^.~.
*~^~^**^^*^^~^#~^^*~~~*^*~~~~*~^^^*~..~~~~~.*~^~*.
^.*.^*^**^^^~**#*.~^~~~^..~~~*~~^*~..^^.^~*.^~^~**
.***^..*^~~~~^~#*^~~.*.~^.^^*.***^~^.*....~.^.*~^^
^^~~~~.**.*.^^*.#~~^....*~*^~*^^.^~~~^*.~^^^~**^~~
^~~*^*.~.*^^^*^.*#.~*...~**^.^^~.^^.^..^.^**.^^..*
~^***~^.~.~^^^*~~~#*..^~^^.~^.~.**...~^~**~^~~**^~
~~~^~.^*.^*.~*.*~~^#.~*^^~~**.*.*.~^^^..^.~^.*.^~~
^^~...^.*~.^^**~^~*.#^~^~*....^.^^**~.*.^^*..~*~.*
^..^...~.~.*.~***~*~~#..~*~^^~~^~**^~~^*^^~*.~*^*^
*^.**^~*****.~~~..~^~#*.^*~^.^^*^..*~^.^.^*.^.~^^*
~...~*^....*^.*^^*...^#~~..^.*~.*~.*^.^*^*^.****^~
^..~***^.*^~~.****.~*^#~.^~*.~^*^~^.****~..~*..*^~
.~^~**~^^..~~~^..*~*.^*#~..^^*.~.*..*~~*~.^~.~*~~.
.***~..~**^.~.~.~*.~~**.#^.^~..~*~~~~*.**~~^..^.^^
~.*.~^*^*~^.~*..*~^~~.*.*#.*.*..^~.*~^^*.~^.^~^**^
.*^~^^*.^*.~*...*~~~*.**.~###*.*^.^*.^*~*.^~^**^*.
.~..*....~..~.***~..~^..~~^*^#^~^^~~**^.*~**^**^^*
^.*.~.^.**^*^.~^^*.~..*^~*^***#~**..^.~~*..^*^~*.~
^~~^~~*.~^^~~^**.^.^^^*^.*^^~~#^##~^*^^..**..**..^
^.^*.*^..*.~~.^^***^.*~..~.**^*#~^#..^^~*.~^~^..~~
~^^.^..*^^.**.~~^*~*^~*~^~~.~*.^~.~#^~*.*..^.^^*^*
^^.~*^~~*.~~*~.^..~*.^.~**.^*^.^~.**#~*.~...~~..*.
.~..^.~.~.^*.~^*~.~.*^*~~*.^.******~#~~*^~~~^.~~*~
~.*..^^*^~*.~~.~.^~..~.~^^^.*~*.**~^#~*^*^^~..^~^^
*.^*^**^*.^^*....**..~^^~.^*^.*~*^**^###*.^^*^^^.~
^*^~^^*.~*~^*~^~~.*.^*^~*^^~.*~.*~.**.*~#~~.~*^~~*
~~**~*.^.*~..~~^^^~^^^.~***^*.^*~^*~^~*~*##..~..~.
*~**^~~.^.*.~^**~*^^.*^*.^~~*~~~*^.*..~~^*^#*^.^.*
.*^~..*~.*^^^^^~~^^*.~*.~~~.***~^.*..~~*****#~~^*.
.^^..^.^*^~^.~*...**~~~.**^*~~~*^***~^*^~^~~^#^*.*
**.**~.**~.*.*^~~.~^.*^.~~*.^*.~.***~*^^..~*.~#^*^
~..^.****^.****~^~***..^^^^*^.~*^^*.~~.^**^*~^*#~~
^*~^.~*...^^.^~.^^..~^...**...^****^*~*~*^..~^*~#~
...^~^.~^^~~~~.*^~.^~***~~^^^.*^^.~.^*~*~**^***^~#
.~~~~~^^.~~*^.~^^^**~^~.^~^~*..^*~^^*..*~^~**.*.^#
~^**.~**..*^~^^^.^*^~^~*^.~*~.^.**.^.^^.~**^~~^~^#
